Norrbotten	Baltic_Sea
Angermanland	Baltic_Sea
Gastrikland	Baltic_Sea
Stockholm	Baltic_Sea
Aland	Baltic_Sea
Oulu	Baltic_Sea
Ostrobothnia	Baltic_Sea
Turku	Baltic_Sea
Gulf_Of_Finland	Baltic_Sea
Gulf_Of_Riga	Baltic_Sea
Kaliningrad	Baltic_Sea
Bornholm	Baltic_Sea
Mecklenburg	Danish_straits_-_Kattegat_-_Skagerrak
Kiel	Danish_straits_-_Kattegat_-_Skagerrak
Great_Belt	Danish_straits_-_Kattegat_-_Skagerrak
Copenhagen	Danish_straits_-_Kattegat_-_Skagerrak
Kattegat	Danish_straits_-_Kattegat_-_Skagerrak
Northern_Jylland	Danish_straits_-_Kattegat_-_Skagerrak
Limfjord	Danish_straits_-_Kattegat_-_Skagerrak
Halland	Danish_straits_-_Kattegat_-_Skagerrak
Halden	Danish_straits_-_Kattegat_-_Skagerrak
Ski	Danish_straits_-_Kattegat_-_Skagerrak
Kragerod_Porsgrunn	Danish_straits_-_Kattegat_-_Skagerrak
Stavanger	Western_Norway
Sotra	Western_Norway
Torvikbygd	Western_Norway
Sula	Western_Norway
Bjugn	Western_Norway
Frosta	Western_Norway
Rotterdam	North_Sea
