Kivalliq	Hudson_Bay
Churchill	Hudson_Bay
West_James_Bay	Hudson_Bay
East_James_Bay	Hudson_Bay
Umiujaq	Hudson_Bay
Inukjuak	Hudson_Bay
Ivujivik	Hudson_Bay
Sugluk	Hudson_Strait
Kangiqsujuaq	Hudson_Strait
Western_Ungava_Bay	Hudson_Strait
Southern_Ungava_Bay	Hudson_Strait
Torngat	Labrador
Nain	Labrador
Hamilton_Inlet	Labrador
Lake_Melville	Labrador
Great_Northern_Peninsula	Newfoundland
Notre_Dame_Bay	Newfoundland
Avalon_Peninsula	Newfoundland
Bay_Of_Islands	Newfoundland
Port_Aux_Basques	Newfoundland
Cape_Breton	Gulf_of_St_Lawrence
Magdalen_Islands	Gulf_of_St_Lawrence
Prince_Edward_Island	Gulf_of_St_Lawrence
Chaleur_Bay	Gulf_of_St_Lawrence
Anticosti_Island	Gulf_of_St_Lawrence
Rimouski	St_Laurence_Lowlands
Forestville	St_Laurence_Lowlands
Quebec_City	St_Laurence_Lowlands
Sable_Island	Maritimes
Halifax	Maritimes
Shelburne	Maritimes
Cumberland	Maritimes
Passamaquoddy_Bay	Maritimes
Eastern_Maine	Northeastern_United_States
Southern_Maine	Northeastern_United_States
